
[[listary]]

-create-filelist <filename> <path>	      创建一个路径的文件列表.

Everything.exe [filename] [options]

filename	      指定打开的文件列表.

-?	      显示帮助.
-admin	      以管理员身份运行 Everything .
-admin-server-share-links	      在 ETP 连接中使用 \\Server\C$ 的链接形式.
-app-data	      保存数据到应用程序数据.
-bookmark <name>	      打开指定的书签.
-case	      启用大小写匹配.
-choose-language	      显示语言选择窗口.
-choose-volumes	      禁用自动索引.
-config <filename>	      指定 ini 文件的文件名.
-connect <user:pass@host:port>	      连接 ETP 服务器.
-console	      显示调试控制台.
-create-filelist <filename> <path>	      创建一个路径的文件列表.
-db <filename>	      指定数据库的文件名.
-debug	      显示调试控制台.
-diacritics	      启用变音符匹配.
-disable-run-as-admin	      禁用以管理员身份运行.
-disable-update-notification	      禁用程序打开时更新通知.
-drive-links	      在 ETP 连接中使用 C: 的链接形式.
-edit <filename>	      用文件列表编辑器打开文件列表.
-enable-run-as-admin	      启用以管理员身份运行.
-enable-update-notification	      启用程序打开时更新通知.
-exit	      退出 "Everything".
-filelist <filename>	      打开指定的文件列表.
-filename <filename>	      搜索指定文件名的文件和文件夹.
-filter <name>	      选择指定的搜索筛选器.
-ftp-links	      在 ETP 连接中使用 ftp://host/C: 的链接形式.
-fullscreen	      全屏显示搜索窗口.
-h	      显示帮助.
-help	      显示帮助.
-install <location>	      安装 Everything 到指定路径.
-install-client-service	      安装 "Everything" 客户服务.
-install-desktop-shortcut	      创建桌面快捷方式.
-install-efu-association	      关联 EFU 文件.
-install-folder-context-menu	      安装文件夹右键菜单.
-install-quick-launch-shortcut	      添加到快速启动栏.
-install-run-on-system-startup	      添加 "Everything" 到启动项.
-install-service	      安装并开启 "Everything" 服务.
-install-service-port <port>	      在指定端口安装 Everything 服务.
-install-start-menu-shortcuts	      添加 "Everything" 到开始菜单.
-install-url-protocol	      安装 URL 协议.
-instance <name>	      指定 Everything 的实例名.
-load-delay <milliseconds>	      载入数据库之前, 指定以毫秒为单位的延迟.
-l	      载入本地数据库.
-language <langID>	      指定语言代码以变更界面语言.
-local	      载入本地数据库.
-matchpath	      启用完整路径匹配.
-maximized	      最大化搜索窗口.
-minimized	      最小化搜索窗口.
-newwindow	      新建搜索窗口.
-noapp-data	      保存数据到应用程序路径.
-nocase	      禁用大小写匹配.
-nodb	      不保存或载入 "Everything" 数据库.
-nodiacritics	      禁用变音符匹配.
-nofullscreen	      窗口化显示搜索窗口.
-nomatchpath	      禁用完整路径匹配.
-nomaximized	      非最大化搜索窗口.
-nominimized	      非最小化搜索窗口.
-nonewwindow	      显示存在的搜索窗口.
-noontop	      禁用总在最前.
-noregex	      禁用正则表达式.
-noverbose	      显示基本调制信息.
-nowholeword	      禁用全字匹配.
-noww	      禁用全字匹配.
-ontop	      启用总在最前.
-p <path>	      搜索指定的路径.
-parentpath <path>	      搜索指定的父目录.
-path <path>	      搜索指定的路径.
-quit	      退出 "Everything".
-read-only	      以只读模式载入数据库.
-regex	      使用正则表达式.
-reindex	      强制重建数据库.
-s <text>	      搜索指定文本.
-search <text>	      搜索指定文本.
-server-share-links	      在 ETP 连接中使用 \\Server\C: 的链接形式.
-service-port <port>	      在指定端口连接 Everything 服务.
-sort <name>	      以指定名称排列.
-sort-ascending	      升序排列.
-sort-descending	      降序排列.
-start-client-service	      开启 Everything 客户服务.
-start-service	      开启 Everything 服务.
-startup	      后台运行 Everything.
-stop-client-service	      停止 Everything 客户服务.
-stop-service	      停止 Everything 服务.
-svc	      以服务形式运行 Everything .
-svc-port <port>	      在指定端口运行 Everything 服务.
-uninstall <path>	      指定 Everything 路径来卸载.
-uninstall-client-service	      移除 "Everything" 客户服务.
-uninstall-desktop-shortcut	      移除桌面快捷方式.
-uninstall-efu-association	      移除 EFU 文件关联.
-uninstall-folder-context-menu	      移除文件夹右键菜单.
-uninstall-quick-launch-shortcut	      从快速启动栏移除.
-uninstall-run-on-system-startup	      移除 "Everything" 启动项.
-uninstall-service	      移除 "Everything" 服务.
-uninstall-start-menu-shortcuts	      从开始菜单中移除 "Everything" .
-uninstall-url-protocol	      卸载 URL 协议.
-uninstall-user	      移除用户文件.
-update	      更新数据库.
-url <[es:]search>	      搜索指定链接 es: URL.
-verbose	      显示所有调试信息.
-wholeword	      启用全字匹配.
-ww	      启用全字符匹配.


